10
S S S S S S S S S S
S 0 0 4 0 0 0 0 0 S
S 0 0 0 0 0 0 0 0 S
S 0 0 4 0 0 0 0 0 S
S 0 T 4 0 0 W T T S
S 0 0 0 4 W W T 0 S
S 0 0 0 0 0 T 0 0 S
S 0 T 0 0 0 0 0 0 S
S 0 T 0 0 0 0 0 0 S
S S S S S S S S S S


